2 7 7 7 7 7 7 7 7 7 7 7 7 7 7 7 7 7 7 7 7 7 7 7 7 7 7 7 7 7 7 7 7 7 7 7 7 7 7 7 7 7 7 7 7 7 7 7 7 4
6 0 0 0 0 0 0 0 0 0 0 0 0 0 0 0 0 0 0 0 0 0 0 0 0 0 0 0 0 0 0 0 0 0 0 0 0 0 0 0 0 0 0 0 0 0 0 0 0 6
6 0 2 4 0 2 7 7 7 7 7 12 7 7 10 0 2 7 7 7 4 0 2 7 7 7 7 4 0 2 7 7 7 4 0 11 7 7 12 7 7 7 7 7 4 0 2 4 0 6
6 0 6 6 0 6 18 18 18 18 18 6 0 0 0 0 6 2 7 7 5 0 3 7 7 7 7 5 0 3 7 7 4 6 0 0 0 0 6 18 18 18 18 18 6 0 6 6 0 6
6 0 6 6 0 3 7 4 2 7 7 5 0 2 7 7 5 6 0 0 0 0 0 0 0 0 0 0 0 0 0 0 6 3 7 7 4 0 3 7 7 4 2 7 5 0 6 6 0 6
6 0 6 6 0 0 0 6 6 0 0 0 0 6 2 7 7 5 0 11 10 0 2 7 7 7 7 4 0 11 10 0 3 7 7 4 6 0 0 0 0 6 6 0 0 0 6 6 0 6
6 0 6 3 7 4 0 3 5 0 2 7 7 5 6 0 0 0 0 0 0 0 13 7 7 7 7 14 0 0 0 0 0 0 0 6 3 7 7 4 0 3 5 0 2 7 5 6 0 6
6 0 3 7 4 6 0 0 0 0 6 2 7 7 5 0 11 7 7 7 10 0 6 0 0 0 0 6 0 11 7 7 7 10 0 3 7 7 4 6 0 0 0 0 6 2 7 5 0 6
6 0 0 0 6 3 7 7 7 7 5 6 0 0 0 0 0 0 0 0 0 0 8 0 2 4 0 8 0 0 0 0 0 0 0 0 0 0 6 3 7 7 7 7 5 6 0 0 0 6
6 0 9 0 3 7 7 4 2 7 7 5 0 2 7 7 7 7 7 7 4 0 0 0 6 6 0 0 0 2 7 7 7 7 7 7 4 0 3 7 7 4 2 7 7 5 0 9 0 6
6 0 6 0 0 0 0 6 6 0 0 0 0 6 18 18 18 18 18 18 6 0 2 7 5 3 7 4 0 6 18 18 18 18 18 18 6 0 0 0 0 6 6 0 0 0 0 6 0 6
6 0 3 7 7 10 0 3 5 0 2 12 7 15 7 7 7 12 7 7 5 0 3 7 7 7 7 5 0 3 7 7 12 7 7 7 15 7 12 4 0 3 5 0 11 7 7 5 0 6
6 0 0 0 0 0 0 0 0 0 3 5 0 0 0 0 0 8 0 0 0 0 0 0 0 0 0 0 0 0 0 0 8 0 0 0 0 0 3 5 0 0 0 0 0 0 0 0 0 6
6 0 2 12 12 12 12 12 4 0 0 0 0 2 12 4 0 0 0 2 4 0 2 10 18 18 11 4 0 2 4 0 0 0 2 12 4 0 0 0 0 2 12 12 12 12 12 4 0 6
6 0 13 1 1 1 1 1 1 7 7 7 7 1 1 1 12 12 12 1 14 0 6 18 18 18 18 6 0 13 1 12 12 12 1 1 1 7 7 7 7 1 1 1 1 1 1 14 0 6
6 0 13 1 1 1 1 1 1 7 7 7 7 1 1 1 15 15 15 1 14 0 3 7 7 7 7 5 0 13 1 15 15 15 1 1 1 7 7 7 7 1 1 1 1 1 1 14 0 6
6 0 3 15 15 15 15 15 5 0 0 0 0 3 15 5 0 0 0 3 5 0 0 0 0 0 0 0 0 3 5 0 0 0 3 15 5 0 0 0 0 3 15 15 15 15 15 5 0 6
6 0 0 0 0 0 0 0 0 0 2 4 0 0 0 0 0 9 0 0 0 0 2 7 7 7 7 4 0 0 0 0 9 0 0 0 0 0 2 4 0 0 0 0 0 0 0 0 0 6
6 0 2 7 7 10 0 2 4 0 3 15 7 12 7 7 7 15 7 7 4 0 6 0 0 0 0 6 0 2 7 7 15 7 7 7 12 7 15 5 0 2 4 0 11 7 7 4 0 6
6 0 6 0 0 0 0 6 6 0 0 0 0 6 18 18 18 18 18 18 6 0 6 0 0 0 0 6 0 6 18 18 18 18 18 18 6 0 0 0 0 6 6 0 0 0 0 6 0 6
6 0 8 0 2 7 7 5 3 7 7 4 0 3 7 7 7 7 7 7 5 0 6 0 2 4 0 6 0 3 7 7 7 7 7 7 5 0 2 7 7 5 3 7 7 4 0 8 0 6
6 0 0 0 6 2 7 7 7 7 4 6 0 0 0 0 0 0 0 0 0 0 6 0 6 6 0 6 0 0 0 0 0 0 0 0 0 0 6 2 7 7 7 7 4 6 0 0 0 6
6 0 2 7 5 6 0 0 0 0 6 3 7 7 4 0 11 7 7 7 10 0 6 0 6 6 0 6 0 11 7 7 7 10 0 2 7 7 5 6 0 0 0 0 6 3 7 4 0 6
6 0 6 2 7 5 0 2 4 0 3 7 7 4 6 0 0 0 0 0 0 0 8 0 6 6 0 8 0 0 0 0 0 0 0 6 2 7 7 5 0 2 4 0 3 7 4 6 0 6
6 0 6 6 0 0 0 6 6 0 0 0 0 6 3 7 7 4 0 11 10 0 0 0 6 6 0 0 0 11 10 0 2 7 7 5 6 0 0 0 0 6 6 0 0 0 6 6 0 6
6 0 6 6 0 2 7 5 3 7 7 4 0 3 7 7 4 6 0 0 0 0 2 7 5 3 7 4 0 0 0 0 6 2 7 7 5 0 2 7 7 5 3 7 4 0 6 6 0 6
6 0 6 6 0 6 18 18 18 18 18 6 0 0 0 0 6 3 7 7 4 0 6 18 18 18 18 6 0 2 7 7 5 6 0 0 0 0 6 18 18 18 18 18 6 0 6 6 0 6
6 0 3 5 0 3 7 7 7 7 7 15 7 7 10 0 3 7 7 7 5 0 3 7 7 7 7 5 0 3 7 7 7 5 0 11 7 7 15 7 7 7 7 7 5 0 3 5 0 6
6 0 0 0 0 0 0 0 0 0 0 0 0 0 0 0 0 0 0 0 0 0 0 0 0 0 0 0 0 0 0 0 0 0 0 0 0 0 0 0 0 0 0 0 0 0 0 0 0 6
3 7 7 7 7 7 7 7 7 7 7 7 7 7 7 7 7 7 7 7 7 7 7 7 7 7 7 7 7 7 7 7 7 7 7 7 7 7 7 7 7 7 7 7 7 7 7 7 7 5