2 7 7 7 7 7 7 7 7 7 7 7 7 7 7 12 7 7 7 7 7 7 7 7 12 7 7 7 7 7 7 7 7 7 7 7 7 7 7 4
6 0 0 0 0 0 0 0 0 0 0 0 0 0 0 6 0 0 0 0 0 0 0 0 6 0 0 0 0 0 0 0 0 0 0 0 0 0 0 6
6 0 2 7 7 7 4 0 2 7 7 4 0 11 7 5 0 2 7 7 7 7 4 0 3 7 10 0 2 7 7 4 0 2 7 7 7 4 0 6
6 0 6 18 18 18 6 0 6 18 18 6 0 0 0 0 0 3 7 7 7 7 5 0 0 0 0 0 6 18 18 6 0 6 18 18 18 6 0 6
6 0 6 18 18 18 6 0 3 7 7 15 7 10 0 9 0 0 0 0 0 0 0 0 9 0 11 7 15 7 7 5 0 6 18 18 18 6 0 6
6 0 6 18 18 18 6 0 0 0 0 0 0 0 0 6 0 2 7 7 7 7 4 0 6 0 0 0 0 0 0 0 0 6 18 18 18 6 0 6
6 0 3 7 7 7 15 7 7 7 7 7 7 7 7 5 0 6 18 18 18 18 6 0 3 7 7 7 7 7 7 7 7 15 7 7 7 5 0 6
6 0 0 0 0 0 0 0 0 0 0 0 0 0 0 0 0 6 18 18 18 18 6 0 0 0 0 0 0 0 0 0 0 0 0 0 0 0 0 6
6 0 2 7 7 7 7 7 10 0 2 7 7 7 7 4 0 6 18 18 18 18 6 0 2 7 7 7 7 4 0 11 7 7 7 7 7 4 0 6
6 0 6 0 0 0 0 0 0 0 6 18 18 18 18 6 0 3 7 7 7 7 5 0 6 18 18 18 18 6 0 0 0 0 0 0 0 6 0 6
6 0 6 0 2 7 7 7 4 0 6 18 18 18 18 6 0 0 0 0 0 0 0 0 6 18 18 18 18 6 0 2 7 7 7 4 0 6 0 6
6 0 6 0 3 7 7 7 5 0 6 18 18 18 18 6 0 2 10 18 18 11 4 0 6 18 18 18 18 6 0 3 7 7 7 5 0 6 0 6
6 0 6 0 0 0 0 0 0 0 6 18 18 18 18 6 0 6 18 18 18 18 6 0 6 18 18 18 18 6 0 0 0 0 0 0 0 6 0 6
6 0 3 7 7 7 7 7 10 0 3 7 7 7 7 5 0 3 7 7 7 7 5 0 3 7 7 7 7 5 0 11 7 7 7 7 7 5 0 6
6 0 0 0 0 0 0 0 0 0 0 0 0 0 0 0 0 0 0 0 0 0 0 0 0 0 0 0 0 0 0 0 0 0 0 0 0 0 0 6
6 0 2 7 7 7 7 7 7 7 7 7 7 7 7 4 0 2 7 7 7 7 4 0 2 7 7 7 7 7 7 7 7 7 7 7 7 4 0 6
6 0 3 7 7 7 7 7 7 7 7 7 7 7 7 5 0 6 2 7 7 7 5 0 3 7 7 7 7 7 7 7 7 7 7 7 7 5 0 6
6 0 0 0 0 0 0 0 0 0 0 0 0 0 0 0 0 6 6 0 0 0 0 0 0 0 0 0 0 0 0 0 0 0 0 0 0 0 0 6
6 0 2 7 7 7 4 0 2 7 7 7 7 7 7 4 0 6 6 0 2 7 4 0 2 7 7 7 7 7 7 4 0 2 7 7 7 4 0 6
6 0 6 18 18 18 6 0 6 18 18 18 18 18 18 6 0 6 6 0 6 18 6 0 6 18 18 18 18 18 18 6 0 6 18 18 18 6 0 6
6 0 6 18 18 18 6 0 6 18 18 2 7 7 7 5 0 6 6 0 6 18 6 0 3 7 7 7 4 18 18 6 0 6 18 18 18 6 0 6
6 0 6 18 18 18 6 0 6 18 18 6 0 0 0 0 0 6 6 0 6 18 6 0 0 0 0 0 6 18 18 6 0 6 18 18 18 6 0 6
6 0 3 7 7 7 5 0 3 7 7 5 0 11 7 4 0 3 5 0 3 7 5 0 2 7 10 0 3 7 7 5 0 3 7 7 7 5 0 6
6 0 0 0 0 0 0 0 0 0 0 0 0 0 0 6 0 0 0 0 0 0 0 0 6 0 0 0 0 0 0 0 0 0 0 0 0 0 0 6
3 7 7 7 7 7 7 7 7 7 7 7 7 7 7 15 7 7 7 7 7 7 7 7 15 7 7 7 7 7 7 7 7 7 7 7 7 7 7 5