2 7 7 7 7 7 7 7 7 7 7 7 7 7 7 7 7 12 7 7 7 7 12 7 7 7 7 7 7 7 7 7 7 7 7 7 7 7 7 4
6 0 0 0 0 0 0 0 0 0 0 0 0 0 0 0 0 3 7 7 7 7 5 0 0 0 0 0 0 0 0 0 0 0 0 0 0 0 0 6
6 0 2 7 7 7 4 0 9 0 9 0 2 7 7 4 0 0 0 0 0 0 0 0 2 7 7 4 0 9 0 9 0 2 7 7 7 4 0 6
6 0 3 7 7 7 14 0 6 0 8 0 3 7 7 5 0 2 4 0 2 7 4 0 3 7 7 5 0 8 0 6 0 3 7 7 7 14 0 6
6 0 0 0 0 0 6 0 6 0 0 0 0 0 0 0 0 6 6 0 6 18 6 0 0 0 0 0 0 0 0 6 0 0 0 0 0 6 0 6
6 0 11 7 10 0 8 0 6 0 2 10 0 11 7 7 7 14 6 0 6 18 13 7 7 7 10 0 11 4 0 6 0 11 7 10 0 8 0 6
6 0 0 0 0 0 0 0 6 0 6 0 0 0 0 0 0 3 5 0 3 7 5 0 0 0 0 0 0 6 0 6 0 0 0 0 0 0 0 6
6 0 11 7 7 7 7 7 5 0 6 0 2 7 7 4 0 0 0 0 0 0 0 0 2 7 7 4 0 6 0 3 7 7 7 7 7 10 0 6
6 0 0 0 0 0 0 0 0 0 6 0 6 18 18 6 0 2 10 18 18 11 4 0 6 18 18 6 0 6 0 0 0 0 0 0 0 0 0 6
6 0 2 7 4 0 2 7 4 0 6 0 6 18 18 6 0 6 18 18 18 18 6 0 6 18 18 6 0 6 0 2 7 4 0 2 7 4 0 6
6 0 3 7 5 0 3 7 5 0 6 0 6 18 18 6 0 3 7 7 7 7 5 0 6 18 18 6 0 6 0 3 7 5 0 3 7 5 0 6
6 0 0 0 0 0 0 0 0 0 6 0 3 7 7 5 0 0 0 0 0 0 0 0 3 7 7 5 0 6 0 0 0 0 0 0 0 0 0 6
6 0 11 7 7 7 7 7 4 0 6 0 0 0 0 0 0 2 4 0 2 7 4 0 0 0 0 0 0 6 0 2 7 7 7 7 7 10 0 6
6 0 0 0 0 0 0 0 6 0 13 10 0 11 7 7 7 14 6 0 6 18 13 7 7 7 10 0 11 14 0 6 0 0 0 0 0 0 0 6
6 0 11 7 10 0 9 0 6 0 8 0 0 0 0 0 0 6 6 0 6 18 6 0 0 0 0 0 0 8 0 6 0 9 0 11 7 10 0 6
6 0 0 0 0 0 6 0 6 0 0 0 9 0 11 10 0 3 5 0 3 7 5 0 11 10 0 9 0 0 0 6 0 6 0 0 0 0 0 6
6 0 2 7 7 7 14 0 6 0 9 0 6 0 0 0 0 0 0 0 0 0 0 0 0 0 0 6 0 9 0 6 0 13 7 7 7 4 0 6
6 0 3 7 7 7 5 0 8 0 8 0 3 7 10 0 11 7 7 7 7 7 7 10 0 11 7 5 0 8 0 8 0 3 7 7 7 5 0 6
6 0 0 0 0 0 0 0 0 0 0 0 0 0 0 0 0 0 0 0 0 0 0 0 0 0 0 0 0 0 0 0 0 0 0 0 0 0 0 6
3 7 7 7 7 7 7 7 7 7 7 7 7 7 7 7 7 7 7 7 7 7 7 7 7 7 7 7 7 7 7 7 7 7 7 7 7 7 7 5